1111111111111111111111111
1000100001000000000000111
1111100011000001010000011
1000000010000000101000001
1000000010000001000000001
1000000010000000010000001
1000000000000000001000001
1111111111111111111111111