11111111111111111111
100P00000000000E0001
1000C000000111000011
1000C0000000C10000C1
11111111111111111111