1111111111111111111111111
100010000100000000C000111
1111100011000001010000011
100000001000000E1C1000001
1000C00010000001000000001
1000000010000000P10000001
1000000000000000001000001
1111111111111111111111111