1111111111
100P000001
10000E0001
10000C0001
1111111111